passwordFieldTooltipfi = Kenttä salasanaa varten
passwordFieldTooltipen = Field for password
passwordFieldTooltippor = Campo para senha

userNameFieldTooltipfi = Kenttä käyttäjänimeä varten
userNameFieldTooltipen = Field for username
userNameFieldTooltippor = Campo para nome de usuário

returnPasswordButonfi = PALAUTA SALASANA
returnPasswordButonen = return password
returnPasswordButonpor = retorna senha

returnPasswordButtonfi = PALAUTA SALASANA
returnPasswordButtonen = return password
returnPasswordButtonpor = retorna senha

passwordLabelfi = Salasana
passwordLabelen = Password
passwordLabelpor = Senha

userLabelfi = Käyttäjänimi
userLabelen = Username
userLabelpor = Nome de usuário

loginImpossiblefi = Käyttäjänimi tai salasana puuttuu!
loginImpossibleen = Username or password is missing!
loginImpossiblepor = Nome de usuário ou senha ausência de!

wrongLoginfi = Väärä käyttäjätunnus tai salasana!
wrongLoginen = Wrong username or password!
wrongLoginpor = Errado nome de usuário ou senha!

closePopupfi = Sulkee popupin
closePopupen = Close popup
closePopuppor = Perto Aparecer

emailTextfieldfi = Tilisi sähköposti
emailTextfielden = Account email
emailTextfieldpor = Conta o email

returnEmailTooltipfi = Palauttaa uuden salasanan sähköpostiin
returnEmailTooltipen = Returns new password to email
returnEmailTooltippor = Retorna nova senha para o email

noEmailfi = Sähköposti puutuu
noEmailen = Email is missing
noEmailpor = O email é ausência de

newPasswordLabelfi = Anna sähköpostiosoitteesi. Tähän osoitteeseen liittyvän käyttäjän salasana palautetaan.
newPasswordLabelen = Give your email to which password is returned.
newPasswordLabelpor = Dar seu o email para qual senho é retornou.

emailLabelfi = Sähköpostiosoite
emailLabelen = Email address
emailLabelpor = O email

formErrorfi = TIETOJA PUUTTUU. TÄYTÄ LOPUT KOHDAT JA YRITÄ UUDELLEEN!
formErroren = Items missing. Fill rest and try again!
formErrorpor = Unid ausência de. Preencher descansar e experimentar novamente!

reservationButtonfi = Tee varaus
reservationButtonen = Make reservation
reservationButtonpor = Faço reserva

reservationNewfi = Uusi varaus
reservationNewen = New reservation
reservationNewpor = Nova reserva

fromfi = Mistä
fromen = From
frompor = De

wherefi = Mihin
whereen = Where
wherepor = Onde

additionalInformationfi = LISÄTIEDOT:
additionalInformationen = Additional information:
additionalInformationpor = Informação adicional:

alertFailedReservationfi = Varauksen teko epäonnistui, koska varauksen aika meni toisen varauksen kanssa päälekäin.
alertFailedReservationen = Reservation failed because it overlapped other reservation.
alertFailedReservationpor = Reserva falhou porque isto sobreposto de outros reserva.

createReservationfi = Luo varauksen
createReservationen = Create reservation
createReservationpor = Crio reserva

startTimefi = Valitse varauksen alkamisaika
startTimeen = Choose start time for reservation
startTimepor = Escolher começar tempo para reserva

startDatefi = Valitse varauksen alkamispäivä
startDateen = Choose start date for reservation
startDatepor = Escolher começar encontro para reserva

endTimefi = Valitse varauksen loppumisaika
endTimeen = Choose end time for reservation
endTimepor = Escolher fim tempo para reserva

endDatefi = Valitse varauksen loppumispäivä
endDateen = Choose end date for reservation
endDatepor = Escolher fim encontro para reserva

reservationReasonfi = Kerro varauksen syy
reservationReasonen = Reason for reservation
reservationReasonpor = Razão par reserva

namefi = Nimi
nameen = Name
namepor = Nome

authorizationfi = Valtuudet
authorizationen = Authorization
authorizationpor = Autorização

newUserfi = Lisää käyttäjä 
newUseren = New user
newUserpor = Novo do utilizador

userReservationfi = KÄYTTÄJÄN VARAUKSET
userReservationen = User's reservations
userReservationpor = Utilizador reserva

removeUserfi = Poista käyttäjä
removeuseren = Remove user
removeuserpor = Remover do utilizador

backfi = Takaisin
backen = Back
backpor = De volta

userInfofi = Käyttäjän tiedot 
userInfoen = User info
userInfopor = Do utilizador info

Logoutfi = Kirjaudu ulos
Logouten = Logout
Logoutpor = Sair

userfi = Käyttäjät
useren =  User
userpor = Comercial

userfi = Käyttäjä
useren = User
userpor = Do utilizador

addUserfi = Avaa popupin käyttäjän lisäämistä varten
addUseren = Open popup for adding user
addUserpor = Avrir aparecer para adicionando do utilizador

removeUserfi = Poista valittu käyttäjän
removeUseren = Remove chosen user
removeUserpor = Remover escolhido do utilizador

returnButtonfi = Palauttaa päänäkymään
returnButtonen = Return to main view
returnButtonpor = Retorna para a principal visão

userReservationTooltipfi = Avaa näkymän, jossa näet valitsemasi käyttäjän varaukset
userReservationTooltipen = Open a view where you can see selected user reservation
userReservationTooltippor = Abrir uma visão onde você posso vejo selecionado do utilizador reserva

confDeleteUserfi = Oletko varma, että haluat poistaa käyttäjän?
confDeleteUseren = Do you want remove selected user?
confDeleteUserpor = Você quer remover o usuário selecionado?

chooseUserfi = Valitse käyttäjä!
chooseUseren = Choose user!
chooseUserpor = Escolha o usuário!

emailDublicatefi = Sähköposti on jo käytössä!
emailDublicateen = Email is already in use!
emailDublicatepor = O e-mail já está sendo usado!

userNameDublicatefi = Käyttäjätunnus on jo käytössä!
userNameDublicateen = User identifier is already in use!
userNameDublicatepor = O identificador de usuários já está em uso!

returnButtonfi = Takaisin
returnButtonen = Return
returnButtonpor = Retorna

resourceNamefi = Laitteen nimi
resourceNameen = Resource Name
resourceNamepor = Nome do recurso

reservationStartdatefi = Varauksen alkamispäivä
reservationStartdateen = Reservation start date
reservationStartdatepor = Data de início da reserva

reservationEnddatefi = Varauksen päätymispäivä
reservationEnddateen = Reservation end date
reservationEnddatepor = Data de término da reserva

reservationIdfi = Varaus ID
reservationIden = Reservation ID
reservationIdpor = Reserva ID

descriptionfi = Kuvaus
descriptionen = Description
descriptionpor = Descrição

activityfi = Aktiivisuus
activityen = Activity
activitypor = Atividade

approvalfi = Hyväksyntä
approvalen = Approval
approvalpor = Aprovação

removeReservationfi = Poista varaus
removeReservationen = Remove reservation
removeReservationpor = Remover reserva

reservationsfi = Varaukset  
reservationsen = Reservations
reservationspor = Reservas

logoutInfofi = Ulos kirjautumunen
logoutInfoen = Logging out
logoutInfopor = Sair

removeReservationInfofi = Poistaa valitun varauksen ja lähettää ilmoituksen käyttäjälle
removeReservationInfoen = Remove chosen reservation and send notification to user
removeReservationInfopor = Remover reserva escolhida e enviar notificação ao usuário

returnUsersWindowfi = Palauttaa hallinnoi henkilöitä -näkymään
returnUsersWindowen = Return to user control view 
returnUsersWindowpor = Retornar para a visualização de controle do usuário

confirmationRemoveReservationfi = Oletko varma, että haluat poistaa varauksen?
confirmationRemoveReservationen = Are you sure that you want remove reservation?
confirmationRemoveReservationpor = Tem certeza de que deseja remover a reserva?

emailFordeletingReservationfi =  on poistettu esimiehen tai ylläpitäjän toimesta.\n \nTämä on automaattinen viesti, johon ei tarvitse vastata.
emailFordeletingReservationen = has been removed by the manager or administrator.\n \nThis is an automatic message that does not need to be answered.
emailFordeletingReservationpor = foi removido pelo gerente ou pelo administrador. \ n \ nEsta é uma mensagem automática que não precisa ser respondida.

errorDeleteReservationfi = Et voi poistaa varausta, joka on vanhentunut tai alkanut!
errorDeleteReservationen = You cannot delete a reservation that has expired or started!
errorDeleteReservationpor = Você não pode excluir uma reserva expirada ou iniciada!

errorChooseReservationfi = Valitse varaus!
errorChooseReservationen = Choose reservation!
errorChooseReservationpor = Escolha a reserva!

isActivefi = Aktiivinen
isActiveen = Is active
isActivepor = Está ativo

isnActivefi = Ei aktiivinen
isnActiveen = Isn't active
isnActivepor = Não é ativo

acknowledgedfi = HYVÄKSYTTY
acknowledgeden = Acknowledged
acknowledgedpor = Reconhecido

inProgressfi = Käsittelyssä
inProgressen = In progress
inProgresspor = Em progresso

bookablefi = Varattavissa
bookableen = Bookable
bookablepor = Reservado

notBookablefi = Ei varattavissa
notBookableen = Not bookable
notBookablepor = Não pode ser reservado

freeUsefi = Vapaa käyttö
freeUseen = Free use
freeUsepor = Uso livre

supApprovedfi = Esimiehen hyväksyttävä
supApproveden = Approved by the supervisor
supApprovedpor = Aprovado pelo supervisor

adApprovedfi = Ylläpitäjän hyväksyttävä
adApproveden = Admin acceptable
adApprovedpor = Admin Aceitável

searchfi = Hae...
searchen = Search...
searchpor = Procurar...

categoryfi = Kategoria
categoryen = Category
categorypor = Categoria

resourcesfi = Resurssit
resourcesen = Resources
resourcespor = Recursos

ownReservationsfi = Omat varaukset
ownReservationsen = Own reservations
ownReservationspor = Reservas próprias

typefi = Tyyppi
typeen = Type
typepor = Tipo

permissionfi = Luvanvaraisuus
permissionen = Permission
permissionpor = Permissão

statefi = Tila
stateen = State
statepor = Estado

resourceNamefi = Laitteen nimi
resourceNameen = Device name
resourceNamepor = Nome do dispositivo

calendarfi = Kalenteri
calendaren = Calendar
calendarpor = Calendário

addResourcefi = Lisää resurssi 
addResourceen = Add resource
addResourcepor = Adicionar recurso

removeResourcefi = Poista resurssi
removeResourceen = Remove resource
removeResourcepor = Remover recurso

manageReservationsfi = Hallinoi varauksia
manageReservationsen = Manage reservations
manageReservationspor = Gerenciar reservas

resourceHistoryfi = Resurssin varaushistoria
resourceHistoryen = Resource history
resourceHistorypor = Histórico de recursos

manageUsersfi = Hallinoi henkilöitä
manageUsersen = Manage users
manageUserspor = Gerenciar usuários

passwordChangefi = Salasanan vaihto 
passwordChangeen = Change password
passwordChangepor = Mudar senha

makeReservationfi = Tee varaus
makeReservationen = Make reservation
makeReservationpor = Fazer reserva

accountNamefi = Käyttäjätunnus
accountNameen = User name
accountNamepor = Nome de usuário

removefi = Poista
removeen = Remove
removepor = Remover

searchByfi = Hakukriteeri
searchByfi = Search by
searchBypor = Procurar por

ownTableTooltipfi = Kaikki järjestelmässä olevat resurssit
ownTableTooltipen = All resources in the system
ownTableTooltippor = Todos os recursos no sistema

hallinnoiBtnTooltipfi = Avaa varauksien hallinta -näkymän
hallinnoiBtnTooltipen = Opens the Manage Reserves view
hallinnoiBtnTooltippor = Abre a visualização Gerenciar Reservas

henkilostoBtnTooltipfi = Avaa käyttäjien hallinta -näkymän
henkilostoBtnTooltipen = Opens the User Management view
henkilostoBtnTooltippor = Abre a visualização Gerenciamento de usuários

lisaaRTooltipfi = Avaa popupin resurssin lisäämistä varten
lisaaRTooltipen = Open popup to add resource
lisaaRTooltippor = Abrir pop-up para adicionar recurso

poistaRTooltipfi = Poistaa valitun resurssin järjestelmästä
poistaRTooltipen = Removes the selected resource from the system
poistaRTooltippor = Remove o recurso selecionado do sistema

salasanaVaihtoBtnfi = Avaa popupin salasanan vaihtoa varten
salasanaVaihtoBtnen = Open a popup to change your password
salasanaVaihtoBtnpor = Abra um pop-up para alterar sua senha

searchBarTooltipfi = Hakukenttä resursseja tai varauksia varten
searchBarTooltipen = Search box for resources or reservations
searchBarTooltippor = Caixa de pesquisa de recursos ou reservas

varausBtnTooltipfi = Avaa popupin varauksen luontia varten, valitse resurssi ensin
varausBtnTooltipen = Open a popup to create a reservation, select a resource first
varausBtnTooltippor = Abra um pop-up para criar uma reserva, selecione um recurso primeiro

kalenteriStackPaneTooltipfi = Voit hakea resursseja päivän mukaan\n valitsemalla halutun päivän kalenterissa. Sen mukaan kalenteri näytää resurssit,\n jotka ovat sinäpäivinnä vapaina.
kalenteriStackPaneTooltipen = You can search for resources by day\n by selecting the desired day in the calendar.\n According to it, the calendar shows resources that are free from the day.
kalenteriStackPaneTooltippor = Você pode procurar recursos por dia selecionando o dia\n desejado no calendário.\n Segundo ele, o calendário mostra recursos que estão livres do dia.

resourceNotAbleReservationfi = Resurssi ei ole tällä hetkellä varattavissa!
resourceNotAbleReservationen = The resource is currently unavailable!
resourceNotAbleReservationpor = O recurso está indisponível no momento!

chooseResourcefi = Valitse resurssi!
chooseResourceen = Choose resource!
chooseResourcepor = Escolha o recurso!

alertConfirmationRemoveResourcefi = Oletko varma, että haluat poistaa resurssin?
alertConfirmationRemoveResourceen = Are you sure you want to remove the resource?
alertConfirmationRemoveResourcepor = Tem certeza de que deseja remover o recurso?

varaajafi = Varaaja
varaajaen = Person
varaajapor = Pessoa

resursinfi = Resurssin
resursinen = Resource's
resursinpor = Recursos

passwordChangeErrormsgfi = TIETOJA PUUTTUU. TÄYTÄ LOPUT KOHDAT JA YRITÄ UUDELLEEN!
passwordChangeErrormsgen = Information missing. COMPLETE FINAL ITEMS AND TRY IT!
passwordChangeErrormsgpor = Informação em falta. COMPLETE ITENS FINAL E TENTE!

changePasswordfi = Vaihda salasana
changePassworden = Change password
changePasswordpor = Mudar senha

changePasswordTitlefi = Salasanan vaihto
changePasswordTitleen = Password change
changePasswordTitlepor = Senha mudar

oldPasswordfi = Vanha salasana
oldPassworden = Old Password
oldPasswordpor = Velho senho

newPasswordfi = Uusi salasana
newPassworden = New Password
newPasswordpor = Novo senho

newPswFieldInfofi = Kenttä uutta salasanaa varten
newPswFieldInfoen = Field for new password
newPswFieldInfopor = Campo para nova senha

repeatPasswordfi = Toista salasana
repeatPassworden = Repeat password
repeatPasswordpor = Repetir senha

oldPswFieldInfofi = Kenttä vanha salasanaa varten
oldPswFieldInfoen = Field for old password
oldPswFieldInfopor = Campo para velho senha

changePasswordInfofi = Vaihtaa salasanaa
changePasswordInfoen = Change password
changePasswordInfopor = Mudar senha

newPasswordError1fi = Uusi salasana ei täsmää tekstikentissä.
newPasswordError1en = The new password does not match the text fields.
newPasswordError1por = A nova senha não corresponde aos campos de texto.

newPasswordError2fi = Vanha salasana väärin.
newPasswordError2en = Old password wrong.
newPasswordError2por = Senha antiga errada.

createUserfi = Luo käyttäjä
createUseren = Create user
createUserpor = Criar usuário

newUserfi = Uusi käyttäjä
newUseren = New user
newUserpor = Neo usuário

userNamefi = Käyttäjän nimi
userNameen = User's name
userNamepor = Nome do usuário

choosefi = Valitse...
chooseen = Choose...
choosepor = Escolher...

employeefi = Työntekijä
employeeen = Employee
employeepor = Empregado

superiorfi = Esimies
superioren = Superior
superiorpor = Superior

administratorfi = Ylläpitäjä
administratoren = Administrator
administratorpor = Administrador

userAutfi = KÄYTTÄJÄN VALTUUDET:
userAuten = USER AUTHORIZATIONS:
userAutpor = AUTORIZAÇÕES DO USUÁRIO:

kayttajaTunnusfi = Käyttäjätunnus
kayttajaTunnusen = User name
kayttajaTunnuspor = Nome de usuário

newUserEmailInfofi = Kenttä sähköpostia varten, ei saa olla olemassa oleva.
newUserEmailInfoen = The field for email must not be an existing one.
newUserEmailInfopor = O campo para email não deve ser um existente.

newUserIdInfofi = Kenttä käyttäjätunnusta varten, ei saa olla olemassa oleva.
newUserIdInfoen = The field for user name must not be an existing one.
newUserIdInfopor = O campo para nome de usuário não deve ser um existente.

newUserNameInfofi = Kenttä käyttäjän nimeä varten.
newUserNameInfoen = Field for user real name.
newUserNameInfopor = Campo para nome de usuário.

newUserPasswordInfofi = Kenttä väliaikaista salasanaa varten.
newUserPasswordInfoen = Field for temporary password.
newUserPasswordInfopor = Campo para senha temporária.

chooseUserAutInfofi = Valitse käyttäjän valtuutus -taso
chooseUserAutInfoen = Select the user authorization level
chooseUserAutInfopor = Selecione o nível de autorização do usuário

createNewUserInfofi = Luo käyttäjän ja lähettää sähköposti ilmoituksen
createNewUserInfoen = Create a user and send an email notification
createNewUserInfopor = Crie um usuário e envie uma notificação por email

newUserErrorLabel1fi = Tietoja puuttuu. Täytä kaikki kohdat ja yritä uudelleen.
newUserErrorLabel1en = Missing information. Fill in all the points and try again.
newUserErrorLabel1por = Faltando informação. Preencha todos os pontos e tente novamente.

newUserErrorLabel2fi = Käyttäjätunnus on jo varattu. Kokeile toista tunnusta.
newUserErrorLabel2en = Your username has already been reserved. Try another ID.
newUserErrorLabel2por = Seu nome de usuário já foi reservado. Tente outro ID.

newUserErrorLabel3fi = Sähköposti on jo varattu. Kokeile toista osoitetta.
newUserErrorLabel3en = Email is already busy. Try another address.
newUserErrorLabel3por = O email já está ocupado. Tente outro endereço.

newUserEmailfi = Hei,\n\nsinulle on luotu keyChain käyttäjä.\nKäyttäjätunnus: 
newUserEmailen = Hi, a KeyChain user has been created for you.\nUser name: 
newUserEmailpor = Oi,\n\num usuário do KeyChain foi criado para você.\nNome do usuário: 

newUserEmailPfi = Salasana: 
newUserEmailPen = Password: 
newUserEmailPpor = Senha: 

newUserEmailConfi = \nMuistathan vaihtaa salasanasi, kun kirjaudut sisään ensimmäisen kerran.\n\nTämä on automaattinen viesti, johon ei tarvitse vastata.
newUserEmailConen = \nPlease remember to change your password when you log in for the first time.\n\n
This is an automatic message that does not need to be answered.
newUserEmailConpor = \nPor favor, lembre-se de alterar sua senha quando você entrar pela primeira vez.\n\nEsta é uma mensagem automática que não precisa ser respondida.

giveInfofi = ANNA TIEDOT:
giveInfoen = GIVE DETAILS:
giveInfopor = DÊ DETALHES:

createNewResourcefi = LUO UUSI RESURSSI
createNewResourceen = CREATE A NEW RESOURCE
createNewResourcepor = CRIAR UM NOVO RECURSO

newResourcefi = UUSI RESURSSI
newResourceen = NEW RESOURCE
newResourcepor = NOVO RECURSO

newResourceChoiceBoxInfofi = Valitse resurssin luvanvaraisuus -taso
newResourceChoiceBoxInfoen = Select the resource permission requirement level
newResourceChoiceBoxInfopor = Selecione o nível de requisito de permissão de recurso

newResourceTextBoxInfofi = Kenttä resurssin kuvausta varten
newResourceTextBoxInfoen = Field for resource description
newResourceTextBoxInfopor = Campo para descrição do recurso

newResourceNameInfofi = Kenttä resurssin nimeä varten, esim. resurssin malli
newResourceNameInfoen = A field for a resource name, eg a resource model
newResourceNameInfopor = Um campo para um nome de recurso, por exemplo, um modelo de recurso

newResourceTypeInfofi = Kenttä resurssin tyyppiä varten, esim. tietokone
newResourceTypeInfoen = Field for resource type, eg computer
newResourceTypeInfopor = Campo para o tipo de recurso, por exemplo, computador

newResourceInfofi = Lisää resurssin järjestelmään
newResourceInfoen = Add a resource to your system
newResourceInfopor = Adicione um recurso ao seu sistema

hylattyfi = Hylätty
hylattyen = Abandoned
hylattypor = Abandonado

acceptfi = Hyväksy
accepten = accept
acceptpor = aceitar

hylkaafi = Hylkää
hylkaaen = Reject
hylkaapor = Rejeitar

kasVarauksetfi = Käsittelemättömät varaukset
kasVaraukseten = Untreated bookings
kasVarauksetpor = Reservas não tratadas

varaajaNimifi = Varaajan nimi
varaajaNimien = Name of the depositor
varaajaNimipor = Nome do depositante

itemfi = Tavara
itemen = Item
itempor = Item

kaikkiVarfi = Kaikki varaukset
kaikkiVaren = All reservations
kaikkiVarpor = Todas as reservas

hylkaaBtnfi = Hylkää valitun varauksen
hylkaaBtnen = Reject the selected reservation
hylkaaBtnpor = Rejeitar a reserva selecionada

hyvaksyBtnfi = Hyväksyy valitun varauksen
hyvaksyBtnen = Accepts the selected reservation
hyvaksyBtnpor = Aceita a reserva selecionada

hyvaksyVarausConffi = Oletko varma, että haluat hyväksyä varauksen?
hyvaksyVarausConfen = Are you sure you want to accept the reservation?
hyvaksyVarausConfpor = Tem certeza de que deseja aceitar a reserva?

hyvaksyVarausEmailfi = on hyväksytty.\n \nTämä on automaattinen viesti, johon ei tarvitse vastata.
hyvaksyVarausEmailen = has been accepted.\n \nThis is an automatic message that does not need to be answered.
hyvaksyVarausEmailpor = foi aceito.\n \nEsta é uma mensagem automática que não precisa ser respondida.

valitseKasVarausfi = Valitse käsiteltävä varaus!
valitseKasVarausen = Select the reservation to be processed!
valitseKasVarauspor = Selecione a reserva a ser processada!

hylataVarausConffi = Oletko varma, että haluat hylätä varauksen?
hylataVarausConfen = Are you sure you want to reject the reservation?
hylataVarausConfpor = Tem certeza de que deseja rejeitar a reserva?

hylataVarausEmailfi = on hylätty.\n \nTämä on automaattinen viesti, johon ei tarvitse vastata.
hylataVarausEmailen = has been rejected.\n \nThis is an automatic message that does not need to be answered.
hylataVarausEmailpor = foi rejeitado.\n \nEsta é uma mensagem automática que não precisa ser respondida.
